B0..EE..B.
.....B...L
D...J....L
B...J..B..
.A.B.WW...
.A........
