B.EE0..B..
.PP......L
....RR...L
....A...B.
....A.....
..........
